21 21 21 21 21 21 21 21 21 21 21 21
24 21 21 21 21 21 21 21 21 21 21 21
24 21 21 21 21 25 25 25 25 21 21 21
24 21 21 21 21 25 25 25 25 21 21 21
24 21 21 21 21 25 25 25 25 21 21 21
24 21 21 21 21 25 25 25 25 21 21 21
24 22 24 21 21 21 21 21 21 21 21 21
24 24 24 22 22 22 22 22 22 22 22 24
21 21 21 21 21 21 21 21 21 21 21 21
21 21 21 21 21 21 21 21 21 21 21 21