21 24 21 24 21 21 21 21 21 24 21 24
21 21 21 24 21 21 21 21 21 21 21 21
24 21 21 24 21 21 22 22 21 21 21 21
24 21 21 24 21 21 21 21 21 21 21 21
21 21 21 24 21 21 21 21 24 21 21 21
21 21 21 21 21 24 21 21 21 21 21 21
21 22 22 22 21 24 21 24 21 21 24 24
21 22 21 22 21 21 21 21 21 21 21 21
21 22 22 22 21 24 21 21 21 21 22 22
24 21 21 21 21 24 21 21 21 21 22 21