04 04 05 04 04 04 04 04 05 04 04 04
04 04 04 04 04 04 04 04 04 04 06 04
04 04 04 04 04 06 04 04 04 04 04 04
04 04 06 04 04 04 04 04 04 04 04 04
04 07 04 04 05 04 07 07 04 04 04 04
04 04 04 04 04 04 04 04 04 07 04 04
04 04 04 04 04 04 04 04 04 04 04 04
04 04 04 04 04 05 04 04 04 04 04 04
04 07 04 06 04 04 04 04 05 04 04 04
04 04 04 04 04 04 04 04 04 04 04 04