09 10 16 10 15 09 13 09 11 09 09 12
09 09 12 09 11 09 12 09 09 09 09 15
09 09 09 09 09 09 09 12 09 09 09 17
09 09 10 09 09 11 09 09 09 10 09 12
09 09 09 11 09 12 09 11 09 09 09 10
14 09 09 09 10 09 09 09 09 09 09 11
12 09 11 10 09 09 09 09 09 09 09 16
13 09 09 09 11 09 09 09 09 10 14 15
09 09 10 09 09 09 09 09 09 10 17 16
09 09 09 09 09 09 10 10 12 10 17 15