09 10 16 17 15 18 13 12 09 20 09 09
09 09 09 09 09 09 12 11 09 09 09 15
10 09 09 09 11 09 09 09 09 09 09 17
11 09 10 09 09 11 13 14 09 09 09 12
09 09 09 11 09 12 09 11 13 14 15 10
14 09 16 09 10 09 09 09 14 09 09 11
12 09 17 09 09 09 09 13 09 09 09 09
13 09 09 09 11 09 12 09 09 09 13 09
13 09 09 09 09 09 09 09 09 09 12 10
17 16 09 09 09 11 10 10 12 09 11 15