09 09 16 17 15 09 13 12 11 12 16 12
09 09 11 12 09 09 12 11 09 09 09 15
11 09 09 13 11 09 09 09 09 09 09 17
11 09 16 14 16 11 13 09 09 09 09 12
12 09 09 15 15 12 09 09 13 14 15 16
14 09 09 09 16 09 09 09 14 13 12 11
12 09 17 09 09 09 09 13 13 11 16 12
13 09 09 09 09 09 12 12 15 17 13 12
13 09 09 09 09 13 15 14 11 13 12 17
17 09 09 09 09 19 19 19 19 19 19 09