21 24 26 26 23 23 23 23 23 21 21 21
21 24 26 23 23 23 23 24 24 24 24 21
21 24 26 26 26 26 26 24 21 21 21 21
21 24 24 24 24 24 24 24 21 21 21 21
21 22 21 21 21 21 21 21 21 24 21 21
21 21 21 21 21 21 21 21 21 22 21 21
21 24 21 22 21 24 21 24 21 21 21 21
22 21 21 21 21 24 21 22 21 24 21 21
21 21 21 24 21 24 21 24 21 21 21 21
24 21 21 21 21 24 21 21 21 21 21 21