04 05 04 05 04 07 04 04 05 04 04 04
04 05 04 06 04 07 04 04 06 04 06 07
04 04 04 04 04 04 04 04 04 04 04 07
06 07 05 07 06 05 06 07 07 05 04 05
04 04 04 04 04 07 04 04 04 07 04 07
04 04 04 06 04 04 04 06 04 06 04 04
04 04 04 04 04 04 04 04 04 07 04 05
04 04 04 04 04 05 07 04 04 04 04 04
04 06 04 04 04 04 04 06 05 04 05 04
04 04 04 04 04 04 04 04 07 04 04 04